......#.#E
.#.##...#.
#.....#.#.
##.##.#.#.
##.##.###.
.......#..
#.##.#.#..
#.##.#.#..
#.#..#.#..
....##....
