##########
#...##...#
#.#!.#.#.#
#.#.##.#.#
#.!..#..##
##.#######
##!.***.##
##!####.##
##!*.#.!##
####E###.#
